-17
20
-11
11
11111111111111111111111111111111111111
01000010000000100100100001000010000101
01011010100100101001010010010101010101
00101010100010100010101010101101011001
00100010000101010100100100010010011001
00100101011100010010100001000100010001
01101010011100101010101101010111110101
00000010010010101000011000010000010101
01000010010001100110011010010100011001
00110010000001010000001000001001101101
00000010001001000000100001110000100101
00101000001010000000111000100010110101
00000001000000000000000001000000001001
01010010100001000000010100000100010001
00000100000110000000000001001000000001
00100001100000001001000000010000101101
00001010011111100001000011001110000001
00000001000000001000001100000000101001
00100000000010000100110000010110001001
00000000000001000010000001000000000001
00100010110000000000000000000100110101
01000000100000000010000000000000000001
11111111111111111111111111111111111111
